00000000000000000000001111111111111111111111111111111111111111111111111111111111111111111111111111111111111111111111111111100000
00000000000000000000000000000000000000000000000000000000000000000000000000000000000000000000000000000000000000000000000000000000
0000000000000000000000000000000000000000000dd00000000000000000000000000000000000000000000000000000000000000000000000dddddddddddd
0000000000000000000000000000000000000000000000000000000e000000000000000a0a0a0a00000d0000000000000000000ddd000000000dddd000000000
0000000000000000000000000000000d0000000000000000a0a00000000000000000g0888888888880e00000000000000000000ddd00000000dd000000a0000a
000000b0000000000000000000000000008888888800008888888800d00000000000000000000000000d0000000dd0000dd00000d00000000dd0000008888888
000000000000ddd0000000000d0000aa0000000000000000000000000000dcddd00000000000000000000000000000000000000000000000d00000a888888888
0000000000000000000000000000888800000000000bc00000000000d00000000000000000000000000d000000000000000000008000000d0000088888888888
00001b1b100000000000000dd000000000000000000000000000000000000000000000000000000000000000000bb0000bb000000000000000a8888888888888
000000000000000000000088880000000000000000dddd0000000000d00088888000000000000000000d00004500004500004500000450000888888888888888
0000000000000a000a000000000000000000000000111100000000000000000000000000000000000000000023a00a23a00a2300000230a88888888888888888
11111111111111111111100000000000000000000000000000000000000000000000000000000000000d00111111111111111100000111111111111111111111

