00000000000000000000dd00000000000000000000000000000000000000000000000000000000000000000000000000000000000000000000000a0000000000
00000000000000000000000000000000000000000000000000ddd00000000000000000000000000000000000000000000000000c000000000000000000000000
0000ddd0000000000000dc00000000000000000000000000000aa0000e0000000000000000000000000000000000000000000000000000000000000000000000
0000ddd0000000000000000f000000f0000000000000g0008888888000000000000000000000000000000g00045000e0000e00000000a00a00a0000000000aaa
0000ddd00000000000d00a00000000000000000000000000000000000d000000000000000000000000000dd0023000000000001110000000000d0000a8888888
0000ddd0000000000000450000000000000000000000000000000000000000bbcb0000000000000000000dd00230000000000000000000000000000888888888
0000ddd0000000d00000230000000000000f000000000000000000000d00000000000e0000e0000000000dd00230000000000000dd000000d000a88888888888
000000000000000045002300000000000000000000000000000000000000000000aa00000000000000000dd00230000d0d0d0d00000000000008888888888888
0000bbb00000000023082300000000000000000000000000000000000d00888888880000000000000000000002300000d0d0d00000000d000888888888888888
00000000000045002300230000d00000d00000d00000d00000d00000000000000000000000000000000000000230000d0d0d0d00450000088888888888888888
000000000000230023002300000000000000000000000000000000000d00000000000000000000000a000aa00230000000000000230008888888888888888888
11111111111111111111110000000000000000000000000000000000000000000000000000000000111111111111111111111111111111111111111111111111

