66666666666666666666666666666666666666666666666666666666666666666666666666666666666666666666666666666666666666666666666666666666
60000000000000000000000000000000000000000000000000000000066666666666666666666666666666666666666666666600007777777777777777777777
60000000000000000000000000000000000000000000000000000000066666666666666666666666666666666666666666666600007777777777777777777777
60000000000000a000a0000000000000000000000000000000000000000000000j00000000000j00000j00000j00000j00000000007777777777777777777777
60000000000666666660000000000000000000000000000000000000000000000000000000000000000000000000000000000000000000000000000000000000
60000000006666666660000c00000000000000000000000000000000000j00000000000j00000000000000000a0000000a000000000000000000000000000000
60000000066666666660000000000000000000000000000000000000666666666666666666666666666666666666666666666600000000000000000000000k00
60000000666666666660000000000000000006600000000000000066666666666666666666666666666666666666666666666600000000000000000000000000
60000006666666666660007j70000000000006600000000066600066666666666666666666666666666666666666666666666600007777777777777777777777
60000066666666666660007770000000000666600066600066600066666666666666666666666666666666666666666666666600007777777777777777777777
60000666666666666660007770000000000666600066600066600066666666666666666666666666666666666666666666666600007777777777777777777777
6666666666666666666hhh777hhhhhh66666666hih666hih666hih666666666666666666666666666666666666666666666666hhih6666666666666666666666
