80000000000000000000000000000000000000000000000000000000000000000000000000000000000000000000000000000000000000000000000000000000
80000000000000000000000000000000000000000000000000000000000000000000000000000000000000000000000000000000000000000000000000000000
8000000000000000000000000000000000000000000000000000bbbb000000000000000000000000000000000000000000000000000000000000000000000000
800000000000000000000000000000000000000000000000000000000000000000000000000000000000000000000000000000000000000000000000000dd000
80000000000000000000000000000000000000000000000g080000l00008e0000000000000000000000000000000000000000000000000000000000000000a00
80000000c000000000000000000000000000000000000000088888888888000000000000dd000000000000000000000000000dddd0000000000000dd000a8888
8000000000000000000000000000000000000000000000000000000000000d0000000000dd0000000000000000bbbbcbb00000000000000000000000a0888888
8000000000000000000000000000000000000000000000000000000000000d0000e00000dd00000000000000l0000000000000000000000000dd000088888888
8000001b1b1000000000000d00d00d00d00d00d000000000000000000000000000d00000dd000000ddd00004500000000045000000000ddd0000a08888888888
845000000000000000000000000000000000000000045000000000000000000000d00000880000000000000230a00a00l0230000000000000000888888888888
82300000000000000000l000000a00a00a00a00a00a2300000000000000000000000000000000000000088888888888888880000000a0000a088888888888888
11111111111111111111111111111111111111111111100000000000000000000000000000000f00000000000000000000000000111111111111111111111111

